11111111111111111111111111111
100000000000000000000000000C1
10000000011100000111110000001
10C00000111100001111111000001
10000001101100011000001100001
10000011001100011000000110001
10000110001100000000000110001
10001100001100000000001100001
1001111111111000C000011000001
10011111111110000000110000001
100000000011000000011000000C1
10000000001100000011000000001
1P000000001100001111111110001
10000000001100011111111110001
100C00000000000000000000000E1
11111111111111111111111111111