1111111111111
1001C000000C1
1000011111001
1P0011E100001
10C0110000001
1001110000011
10C0000011C01
1111111111111